Node labels: [{'label': 'Question'}, {'label': 'MetaInfo'}, {'label': 'Option'}, {'label': 'Focus'}, {'label': 'Type'}, {'label': 'Answer'}, {'label': 'Keyword'}, {'label': 'Kid'}, {'label': 'Discipline'}, {'label': 'Property'}, {'label': 'Cell'}, {'label': 'Tissue'}, {'label': 'Process'}, {'label': 'Disease'}, {'label': 'Technique'}, {'label': 'Concept'}, {'label': 'Structure'}, {'label': 'Artery'}, {'label': 'Cavity'}, {'label': 'Specimen'}, {'label': 'Material'}, {'label': 'Approach'}, {'label': 'BodyRegion'}, {'label': 'Organ'}, {'label': 'BodySystem'}, {'label': 'System'}, {'label': 'Body'}, {'label': 'Procedure'}, {'label': 'Treatment'}, {'label': 'Finding'}, {'label': 'AnatomicalRegion'}, {'label': 'Anatomy'}, {'label': 'GrossAnatomy'}, {'label': 'MicroscopicAnatomy'}, {'label': 'Histology'}, {'label': 'Medicine'}, {'label': 'PhysicalExamination'}, {'label': 'ImagingTechnique'}, {'label': 'Dentist'}, {'label': 'Chiropractor'}, {'label': 'PhysicalTherapist'}, {'label': 'PatientTreatment'}, {'label': 'ClinicalSign'}, {'label': 'ClinicalObservation'}, {'label': 'Information'}, {'label': 'AnatomicalStructure'}, {'label': 'Model'}, {'label': 'Tool'}, {'label': 'BodyPart'}, {'label': 'LearningTool'}, {'label': 'AnatomicalPosition'}, {'label': 'Plane'}, {'label': 'Part'}, {'label': 'Term'}, {'label': 'DirectionalTerm'}, {'label': 'Direction'}, {'label': 'Position'}, {'label': 'MedicalCondition'}, {'label': 'Person'}, {'label': 'DiagnosticImaging'}, {'label': 'Device'}, {'label': 'Time'}, {'label': 'Technology'}, {'label': 'ElectromagneticRadiation'}, {'label': 'Substance'}, {'label': 'XRayTechnique'}, {'label': 'XRay'}, {'label': 'XRayTube'}, {'label': 'InputScreen'}, {'label': 'BariumStudy'}, {'label': 'Angiography'}, {'label': 'Fluoroscopy'}, {'label': 'BowelLoop'}, {'label': 'BariumSulfate'}, {'label': 'GastrointestinalTract'}, {'label': 'BowelLumen'}, {'label': 'Air'}, {'label': 'DoubleContrastStudy'}, {'label': 'BariumEnema'}, {'label': 'BodyCavity'}, {'label': 'MedicalProcedure'}, {'label': 'ChemicalSubstance'}, {'label': 'PhysiologicalProcess'}, {'label': 'OrganSystem'}, {'label': 'Image'}, {'label': 'PhysicalProperty'}, {'label': 'Computer'}, {'label': 'MedicalDevice'}, {'label': 'AnatomicalPlane'}, {'label': 'Radiation'}, {'label': 'PhysicsConcept'}, {'label': 'SubatomicParticle'}, {'label': 'ImagingParameter'}, {'label': 'ImagingType'}, {'label': 'Fluid'}, {'label': 'Circulation'}, {'label': 'Radionuclide'}, {'label': 'ChemicalCompound'}, {'label': 'Radiopharmaceutical'}, {'label': 'Absorption'}, {'label': 'Distribution'}, {'label': 'Metabolism'}, {'label': 'Excretion'}, {'label': 'GammaCamera'}, {'label': 'Imaging'}, {'label': 'PositronEmissionTomography'}, {'label': 'Positron'}, {'label': 'Cyclotron'}, {'label': 'Fluorodeoxyglucose'}, {'label': 'Fluorine18'}, {'label': 'Glucose'}, {'label': 'HotSpot'}, {'label': 'Cancer'}, {'label': 'Recurrence'}, {'label': 'SinglePhotonEmissionComputedTomography'}, {'label': 'GammaRay'}, {'label': 'Technetium99m'}, {'label': 'Iodine123'}, {'label': 'Iodine131'}, {'label': 'CoronaryArteryDisease'}, {'label': 'BoneFracture'}, {'label': 'RadiographyProcedure'}, {'label': 'QualityAssessment'}, {'label': 'MedicalSign'}, {'label': 'Indication'}, {'label': 'ContrastMedium'}, {'label': 'Gas'}, {'label': 'Medication'}, {'label': 'AnatomicalSystem'}, {'label': 'Vessel'}, {'label': 'Fiber'}, {'label': 'VesselClass'}, {'label': 'Physiology'}, {'label': 'MedicalConcept'}, {'label': 'Document'}]
Relationship types: [{'relationshipType': 'TAGGED_AS'}, {'relationshipType': 'HAS_OPTION'}, {'relationshipType': 'HAS_FOCUS'}, {'relationshipType': 'HAS_TYPE'}, {'relationshipType': 'HAS_ANSWER'}, {'relationshipType': 'HAS_KEYWORD'}, {'relationshipType': 'HAS_KID'}, {'relationshipType': 'INCLUDES'}, {'relationshipType': 'SYNONYM_OF'}, {'relationshipType': 'STUDIES'}, {'relationshipType': 'FORMS_BASIS_FOR'}, {'relationshipType': 'LEADS_TO_UNDERSTANDING_OF'}, {'relationshipType': 'IMPORTANT_FOR'}, {'relationshipType': 'USES'}, {'relationshipType': 'USED_TO_LEARN'}, {'relationshipType': 'BRANCH_OF'}, {'relationshipType': 'ORIGINATES_IN'}, {'relationshipType': 'TERMINATES_IN'}, {'relationshipType': 'RELATED_TO'}, {'relationshipType': 'INVOLVED_IN'}, {'relationshipType': 'PERFORMED_ON'}, {'relationshipType': 'STUDIES_REGION'}, {'relationshipType': 'CONTAINS'}, {'relationshipType': 'STUDIES_SYSTEM'}, {'relationshipType': 'INVOLVES'}, {'relationshipType': 'FOSTERS_UNDERSTANDING_OF'}, {'relationshipType': 'LOCATED_IN'}, {'relationshipType': 'DIFFICULT_TO_COORDINATE_WITH'}, {'relationshipType': 'SYNONYMOUS_WITH'}, {'relationshipType': 'LEADS_TO'}, {'relationshipType': 'SUBJECT_OF'}, {'relationshipType': 'USED_TO_STUDY'}, {'relationshipType': 'LEADS_TO_INTERPRETATION_OF'}, {'relationshipType': 'BEGINS_WITH'}, {'relationshipType': 'PART_OF'}, {'relationshipType': 'STUDY_METHOD_OF'}, {'relationshipType': 'STUDY_AID_FOR'}, {'relationshipType': 'STUDY_APPROACH_OF'}, {'relationshipType': 'BENEFITS_FROM'}, {'relationshipType': 'FALLS_SHORT_UNDERSTANDING'}, {'relationshipType': 'DIFFICULT_TO_ACQUIRE'}, {'relationshipType': 'REQUIRES'}, {'relationshipType': 'STUDIED_BY'}, {'relationshipType': 'HAS_POSITION'}, {'relationshipType': 'PASSES_THROUGH'}, {'relationshipType': 'DIVIDES_INTO'}, {'relationshipType': 'LOCATED_ANTERIOR_TO'}, {'relationshipType': 'LOCATED_POSTERIOR_TO'}, {'relationshipType': 'LOCATED_LATERAL_TO'}, {'relationshipType': 'LOCATED_MEDIAL_TO'}, {'relationshipType': 'IS_LATERAL_TO'}, {'relationshipType': 'IS_MEDIAL_TO'}, {'relationshipType': 'IS_SUPERIOR_TO'}, {'relationshipType': 'IS_INFERIOR_TO'}, {'relationshipType': 'IS_DISTAL_TO'}, {'relationshipType': 'IS_PROXIMAL_TO'}, {'relationshipType': 'IS_ROSTRAL_TO'}, {'relationshipType': 'LOCATED_ROSTRAL_TO'}, {'relationshipType': 'IS_SUPERFICIAL_TO'}, {'relationshipType': 'IS_DEEP_TO'}, {'relationshipType': 'IS_EXTERNAL_TO'}, {'relationshipType': 'IS_ENCLOSED_BY'}, {'relationshipType': 'IS_PART_OF'}, {'relationshipType': 'PENETRATES'}, {'relationshipType': 'DISCOVERED'}, {'relationshipType': 'USED'}, {'relationshipType': 'PRODUCED_BY'}, {'relationshipType': 'IMAGES'}, {'relationshipType': 'PARALLELED_BY'}, {'relationshipType': 'REVOLUTIONIZED'}, {'relationshipType': 'PIONEERED'}, {'relationshipType': 'GENERATED_BY'}, {'relationshipType': 'VISUALIZES'}, {'relationshipType': 'INTERACTS_WITH'}, {'relationshipType': 'AFFECTS'}, {'relationshipType': 'PRODUCES'}, {'relationshipType': 'CONNECTED_TO'}, {'relationshipType': 'USED_IN'}, {'relationshipType': 'EXAMINES'}, {'relationshipType': 'IS_A'}, {'relationshipType': 'ATTENUATED_BY'}, {'relationshipType': 'ATTENUATES'}, {'relationshipType': 'DEMONSTRATES'}, {'relationshipType': 'INSTILLS_INTO'}, {'relationshipType': 'TARGETS'}, {'relationshipType': 'UNDERGOES'}, {'relationshipType': 'CAN_CAUSE'}, {'relationshipType': 'OBSTRUCTED_BY'}, {'relationshipType': 'SHOWS'}, {'relationshipType': 'SUBTRACTS'}, {'relationshipType': 'ENHANCED_BY'}, {'relationshipType': 'RECEIVES'}, {'relationshipType': 'DETECTED_BY'}, {'relationshipType': 'ASSESSES'}, {'relationshipType': 'ASSOCIATED_WITH'}, {'relationshipType': 'DEPENDS_ON'}, {'relationshipType': 'INFLUENCES'}, {'relationshipType': 'PROVIDES'}, {'relationshipType': 'PROVIDES_INFORMATION_ON'}, {'relationshipType': 'APPLIED_TO'}, {'relationshipType': 'OCCURS_IN'}, {'relationshipType': 'HAS'}, {'relationshipType': 'COMPARED_TO'}, {'relationshipType': 'IDENTIFIES'}, {'relationshipType': 'DIFFERS_FROM'}, {'relationshipType': 'BINDS_TO'}, {'relationshipType': 'ALLOWS_ASSESSMENT_OF'}, {'relationshipType': 'COMBINES_WITH'}, {'relationshipType': 'HAS_PROPERTY'}, {'relationshipType': 'AFFECTED_BY'}, {'relationshipType': 'DETECTS'}, {'relationshipType': 'EMITTED_FROM'}, {'relationshipType': 'LABELED_WITH'}, {'relationshipType': 'TAKEN_UP_BY'}, {'relationshipType': 'ANALOG_OF'}, {'relationshipType': 'RESULT_OF'}, {'relationshipType': 'DIAGNOSES'}, {'relationshipType': 'EMITTER_OF'}, {'relationshipType': 'EXAMPLE_OF'}, {'relationshipType': 'POSITIONED_NEAR'}, {'relationshipType': 'USED_FOR'}, {'relationshipType': 'PERFORMED_IN_POSITION'}, {'relationshipType': 'ALTERNATIVE_TO'}, {'relationshipType': 'ASSESSED_FOR'}, {'relationshipType': 'IMAGING_OF'}, {'relationshipType': 'VARIANT_OF'}, {'relationshipType': 'INDICATED_FOR'}, {'relationshipType': 'OPPOSITE_OF'}, {'relationshipType': 'OPACIFIES'}, {'relationshipType': 'PREPARES'}, {'relationshipType': 'CAPABLE_OF'}, {'relationshipType': 'FUNCTIONALLY_RELATED_TO'}, {'relationshipType': 'REGULATES'}, {'relationshipType': 'CONTRIBUTES_TO'}, {'relationshipType': 'HAS_QUESTION'}]
Property keys: [{'propertyKey': 'text'}, {'propertyKey': 'name'}, {'propertyKey': 'letter'}, {'propertyKey': 'correct'}, {'propertyKey': 'qid'}, {'propertyKey': 'subject'}, {'propertyKey': 'message'}, {'propertyKey': 'nist_paraphrase'}, {'propertyKey': 'summary'}, {'propertyKey': 'fid'}, {'propertyKey': 'category'}, {'propertyKey': 'tid'}, {'propertyKey': 'has_focus'}, {'propertyKey': 'aid'}, {'propertyKey': 'answer'}, {'propertyKey': 'url'}, {'propertyKey': 'comment'}, {'propertyKey': 'kid'}, {'propertyKey': 'unique_key'}, {'propertyKey': 'id'}, {'propertyKey': 'description'}, {'propertyKey': 'property'}, {'propertyKey': 'origin'}, {'propertyKey': 'meaning'}, {'propertyKey': 'location'}, {'propertyKey': 'part_of'}, {'propertyKey': 'involves'}, {'propertyKey': 'sufficiency'}, {'propertyKey': 'side'}, {'propertyKey': 'relation'}, {'propertyKey': 'value'}, {'propertyKey': 'degree'}, {'propertyKey': 'increase'}, {'propertyKey': 'characteristic'}, {'propertyKey': 'embedding'}, {'propertyKey': 'document_id'}, {'propertyKey': 'source'}, {'propertyKey': 'question_id'}, {'propertyKey': 'type'}]
Database schema information:
Sample Question node: [{'n': {'text': 'A 67-year-old woman comes to the clinic complaining of progressive fatigue over the past 4 months. She noticed that she is feeling increasingly short of breath after walking the same distance from the bus stop to her home. She denies chest pain, syncope, lower extremity edema, or a cough. She denies difficulty breathing while sitting comfortably, but she has increased dyspnea upon walking or other mildly strenuous activity. Her past medical history includes mild osteoporosis and occasional gastric reflux disease. She takes oral omeprazole as needed and a daily baby aspirin. The patient is a retired accountant and denies smoking history, but she does admit to 1 small glass of red wine daily for the past 5 years. Her diet consists of a Mediterranean diet that includes fruits, vegetables, and fish. She states that she has been very healthy previously, and managed her own health without a physician for the past 20 years. On physical examination, she has a blood pressure of 128/72 mm Hg, a pulse of 87/min, and an oxygen saturation of 94% on room air. HEENT examination demonstrates mild conjunctival pallor. Lung and abdominal examinations are within normal limits. Heart examination reveals a 2/6 systolic murmur at the right upper sternal border.\nThe following laboratory values are obtained:\nHematocrit 29%\nHemoglobin 9.8 mg/dL\nMean red blood cell volume 78 fL\nPlatelets 240,000/mm3\nWhite blood cells 6,000/mm3\nWhat is the most likely reticulocyte range for this patient?'}}]
Sample MetaInfo node: [{'n': {'name': 'step1'}}]
Sample Option node: [{'n': {'letter': 'A', 'text': '< 1%'}}]
Sample Focus node: [{'n': {'fid': 'F1', 'text': 'Iron Overdose', 'category': 'Problem'}}]
Sample Type node: [{'n': {'has_focus': 'F1', 'text': 'INFORMATION', 'tid': 'T1'}}]
Sample Answer node: [{'n': {'text': 'Unknown'}}]
Sample Keyword node: [{'n': {'unique_key': 'TQ72_K1', 'text': 'measles vaccination', 'category': 'ProcedureDevice'}}]
Sample Kid node: [{'n': {'kid': 'K1'}}]
Sample Discipline node: [{'n': {'name': 'Anatomy', 'description': 'The branch of science concerned with the bodily structure of humans, animals, and other living organisms, especially as revealed by dissection and the separation of parts.', 'id': 'anatomy'}}]
Sample Property node: [{'n': {'name': 'Brownian Motion', 'description': 'The random movement of particles in a fluid or gas due to collisions with other atoms or molecules.', 'id': 'brownian_motion'}}]
Sample Cell node: [{'n': {'name': 'Cell', 'description': 'The basic structural and functional unit of all known living organisms. It is the smallest unit of an organism that is considered a living thing.', 'id': 'cell'}}]
Sample Tissue node: [{'n': {'name': 'Soft Tissues', 'description': 'Tissues that are not hardened by mineralization processes such as bones.', 'id': 'soft_tissues'}}]
Sample Process node: [{'n': {'name': 'Circulation', 'description': 'The continuous movement of blood through the heart and blood vessels.', 'id': 'circulation'}}]
Sample Disease node: [{'n': {'name': 'Anaphylactic Reaction', 'description': 'A severe, potentially life-threatening allergic reaction that can occur in response to intra-arterial or intravenous injections of contrast agents.', 'id': 'anaphylactic_reaction'}}]
Sample Technique node: [{'n': {'name': 'Observation', 'description': 'The act of observing, a primary technique for learning anatomy, involving visual examination and attention to detail.', 'id': 'observation'}}]
Sample Concept node: [{'n': {'name': 'Anatomical Position', 'description': 'The standard reference point for anatomical descriptions, where the body is erect, feet forward, arms at the sides, and palms facing forward.', 'id': 'anatomical_position'}}]
Sample Structure node: [{'n': {'name': 'Vasculature', 'description': 'The network of blood vessels in a particular organ or part of the body.', 'id': 'vasculature'}}]
Sample Artery node: [{'n': {'name': 'External Carotid Artery', 'description': 'A major artery in the neck that supplies blood to the face and scalp.', 'id': 'external_carotid_artery'}}]
Sample Cavity node: [{'n': {'name': 'Oral Cavity', 'description': 'The mouth, containing the tongue, teeth, and salivary glands.', 'id': 'oral_cavity'}}]
Sample Specimen node: [{'n': {'name': 'Cadaver', 'description': 'A dead human body, used for anatomical study.', 'id': 'cadaver'}}]
Sample Material node: [{'n': {'name': 'Piezoelectric Materials', 'description': 'Materials that generate an electric charge when subjected to mechanical stress, and vice versa.', 'id': 'piezoelectric_materials'}}]
Sample Approach node: [{'n': {'name': 'Regional Approach', 'description': 'A method of studying anatomy by focusing on specific regions of the body.', 'id': 'regional_approach'}}]
Sample BodyRegion node: [{'n': {'name': 'Thorax', 'description': 'The region of the body between the neck and the abdomen, containing vital organs such as the heart and lungs, protected by the rib cage.', 'id': 'thorax'}}]
Sample Organ node: [{'n': {'name': 'Internal Organs', 'description': 'Organs located within the body.', 'id': 'internal_organs'}}]
Sample BodySystem node: [{'n': {'name': 'Cardiovascular System', 'description': 'The system responsible for circulating blood throughout the body, consisting of the heart, blood vessels (arteries, veins, and capillaries), and blood, transporting oxygen, nutrients, hormones, and waste products.', 'id': 'cardiovascular_system'}}]
Sample System node: [{'n': {'name': 'Cardiovascular System', 'description': 'The system responsible for circulating blood, including the heart and blood vessels.', 'id': 'cardiovascular_system'}}]
Sample Body node: [{'n': {'name': 'Body', 'description': 'The entire physical structure of a human being, used as the reference for anatomical study and description.', 'id': 'body'}}]
Sample Procedure node: [{'n': {'name': 'Imaging', 'description': 'The process of creating visual representations of the interior of a body for clinical analysis and medical intervention.', 'id': 'imaging'}}]
Sample Treatment node: [{'n': {'name': 'Treatment', 'description': 'Medical care given to a patient for an illness or injury.', 'id': 'treatment'}}]
Sample Finding node: [{'n': {'name': 'Pathological changes', 'description': 'Alterations in tissues due to disease or injury, detectable through medical imaging.', 'id': 'pathological_changes'}}]
Sample AnatomicalRegion node: [{'n': {'name': 'Anatomy', 'description': 'The study of the structure of the body and its parts.', 'id': 'anatomy'}}]
Sample Anatomy node: [{'n': {'name': 'Anatomy', 'description': 'The study of the structure of the body, including both gross (macroscopic) and microscopic structures. It forms the basis for medical practice and understanding disease processes.', 'id': 'anatomy'}}]
Sample GrossAnatomy node: [{'n': {'name': 'Gross Anatomy', 'description': 'The study of anatomical structures that can be seen without the aid of magnification; also known as macroscopic anatomy.', 'id': 'gross_anatomy'}}]
Sample MicroscopicAnatomy node: [{'n': {'name': 'Microscopic Anatomy', 'description': 'The study of cells and tissues using a microscope; also called histology.', 'id': 'microscopic_anatomy'}}]
Sample Histology node: [{'n': {'name': 'Histology', 'description': 'The study of cells and tissues using a microscope; also known as microscopic anatomy.', 'id': 'histology'}}]
Sample Medicine node: [{'n': {'name': 'Medicine', 'description': 'The science or practice of the diagnosis, treatment, and prevention of disease.', 'id': 'medicine'}}]
Sample PhysicalExamination node: [{'n': {'name': 'Physical Examination', 'description': 'An examination of the body to determine the state of health.', 'id': 'physical_examination'}}]
Sample ImagingTechnique node: [{'n': {'name': 'Angiography', 'description': 'Angiography is an imaging technique used to visualize blood vessels. It involves injecting a contrast agent into the vessels and using X-rays to create images. Often difficult to appreciate the contrast agent in the vessels through the overlying bony structures.', 'id': 'angiography'}}]
Sample Dentist node: [{'n': {'name': 'Dentist', 'description': 'A healthcare professional who specializes in dentistry.', 'id': 'dentist'}}]
Sample Chiropractor node: [{'n': {'name': 'Chiropractor', 'description': 'A healthcare professional focused on the diagnosis, treatment and prevention of mechanical disorders of the musculoskeletal system, especially the spine.', 'id': 'chiropractor'}}]
Sample PhysicalTherapist node: [{'n': {'name': 'Physical Therapist', 'description': 'A healthcare professional who helps patients recover from injuries and illnesses through exercise and rehabilitation.', 'id': 'physical_therapist'}}]
Sample PatientTreatment node: [{'n': {'name': 'Patient Treatment', 'description': 'The management and care of a patient to combat disease or disorder.', 'id': 'patient_treatment'}}]
Sample ClinicalSign node: [{'n': {'name': 'Clinical Sign', 'description': 'Objective evidence of disease, as opposed to a symptom, which is subjective.', 'id': 'clinical_sign'}}]
Sample ClinicalObservation node: [{'n': {'name': 'Clinical Observation', 'description': 'The act of noting and recording something, such as a clinical sign, with instruments.', 'id': 'clinical_observation'}}]
Sample Information node: [{'n': {'name': 'Network of Information', 'description': 'Interconnected data required to visualize the position of physical structures in a patient, going beyond simple memorization.', 'id': 'network_of_information'}}]
Sample AnatomicalStructure node: [{'n': {'name': 'Artery', 'description': 'A blood vessel that carries blood away from the heart to the body. Contrast agents can be injected into arteries to visualize them.', 'id': 'artery'}}]
Sample Model node: [{'n': {'name': 'Plastic Model', 'description': 'A three-dimensional representation of anatomical structures made of plastic.', 'id': 'plastic_model'}}]
Sample Tool node: [{'n': {'name': 'Computer Teaching Modules', 'description': 'Interactive software used for anatomical education.', 'id': 'computer_teaching_modules'}}]
Sample BodyPart node: [{'n': {'name': 'Neck', 'description': 'The part of the body connecting the head and torso. It contains various anatomical structures, including arteries, veins, nerves, and muscles.', 'id': 'neck'}}]
Sample LearningTool node: [{'n': {'name': 'Computer Teaching Module', 'description': 'An interactive computer program used to teach anatomy. Computer teaching modules can provide a virtual dissection experience.', 'id': 'computer_module'}}]
Sample AnatomicalPosition node: [{'n': {'name': 'Anatomical Position', 'description': 'The standard reference position for anatomical descriptions, with the body erect, feet forward, and arms at the sides with palms facing forward.', 'id': 'anatomical_position'}}]
Sample Plane node: [{'n': {'name': 'Coronal Plane', 'description': 'A vertical plane that divides the body into anterior (front) and posterior (back) parts. Also known as the frontal plane.', 'id': 'coronal_plane'}}]
Sample Part node: [{'n': {'name': 'Anterior Part', 'description': 'The front portion of the body or a structure, located towards the front.', 'id': 'anterior_part'}}]
Sample Term node: [{'n': {'name': 'Anterior', 'description': 'A term describing the position of a structure towards the front of the body. Also known as ventral.', 'id': 'anterior'}}]
Sample DirectionalTerm node: [{'n': {'name': 'Medial', 'description': 'Directional term indicating a position closer to the median sagittal plane of the body.', 'id': 'medial'}}]
Sample Direction node: [{'n': {'name': 'Cranial', 'description': 'Directional term meaning toward the head. Sometimes used instead of superior.', 'id': 'cranial'}}]
Sample Position node: [{'n': {'name': 'Superficial', 'description': 'A position closer to the surface of the body. Can also define a major region of the body external to the outer layer of deep fascia.', 'id': 'superficial'}}]
Sample MedicalCondition node: [{'n': {'name': 'Wound', 'description': 'A wound is an injury to living tissue caused by a cut, blow, or other impact, typically one in which the skin is cut or broken.', 'id': 'wound'}}]
Sample Person node: [{'n': {'name': 'Wilhelm Roentgen', 'description': 'The scientist who discovered X-rays in 1895.', 'id': 'wilhelm_roentgen'}}]
Sample DiagnosticImaging node: [{'n': {'name': 'X-rays', 'description': 'A form of electromagnetic radiation used in diagnostic imaging.', 'id': 'x_rays'}}]
Sample Device node: [{'n': {'name': 'Gamma camera', 'description': 'A device used in nuclear medicine to detect gamma rays emitted from radiopharmaceuticals within the body, producing images of organs and tissues.', 'id': 'gamma_camera'}}]
Sample Time node: [{'n': {'name': '1895', 'description': 'The year Wilhelm Roentgen discovered X-rays.', 'id': 'year:1895'}}]
Sample Technology node: [{'n': {'name': 'Computer Technology', 'description': 'The technology related to computers.', 'id': 'computer_technology'}}]
Sample ElectromagneticRadiation node: [{'n': {'name': 'Gamma rays', 'description': 'A type of electromagnetic radiation produced from within the nucleus of an atom when an unstable nucleus decays. Used in nuclear medicine for imaging.', 'id': 'gamma_rays'}}]
Sample Substance node: [{'n': {'name': 'Contrast Agent', 'description': 'A substance injected into blood vessels to enhance their visibility during imaging techniques like angiography.', 'id': 'contrast_agent'}}]
Sample XRayTechnique node: [{'n': {'name': 'X-ray technique', 'description': 'A medical imaging technique using X-rays to visualize internal structures.', 'id': 'xray_technique'}}]
Sample XRay node: [{'n': {'name': 'X-ray', 'description': 'A form of electromagnetic radiation used in medical imaging to visualize internal structures due to differential absorption.', 'id': 'xray'}}]
Sample XRayTube node: [{'n': {'name': 'X-ray tube', 'description': 'A vacuum tube that produces X-rays when high-velocity electrons collide with a metal target.', 'id': 'xray_tube'}}]
Sample InputScreen node: [{'n': {'name': 'Input screen', 'description': 'A device that detects and displays the X-ray image produced.', 'id': 'input_screen'}}]
Sample BariumStudy node: [{'n': {'name': 'Barium study', 'description': 'A medical imaging technique using barium sulfate to enhance the visualization of the gastrointestinal tract.', 'id': 'barium_study'}}]
Sample Angiography node: [{'n': {'name': 'Angiography', 'description': 'A medical imaging technique used to visualize blood vessels.', 'id': 'angiography'}}]
Sample Fluoroscopy node: [{'n': {'name': 'Fluoroscopy', 'description': 'A medical imaging technique that uses X-rays to obtain real-time moving images of internal structures.', 'id': 'fluoroscopy'}}]
Sample BowelLoop node: [{'n': {'name': 'Bowel loop', 'description': 'A segment of the intestine forming a loop-like structure.', 'id': 'bowel_loop'}}]
Sample BariumSulfate node: [{'n': {'name': 'Barium sulfate', 'description': 'An insoluble salt used as a contrast agent in medical imaging, particularly for the gastrointestinal tract, to enhance X-ray visualization due to its high density and X-ray attenuation properties. It is considered nontoxic.', 'id': 'barium_sulfate'}}]
Sample GastrointestinalTract node: [{'n': {'name': 'Gastrointestinal tract', 'description': 'The digestive system, responsible for processing food and absorbing nutrients.', 'id': 'gastrointestinal_tract'}}]
Sample BowelLumen node: [{'n': {'name': 'Bowel lumen', 'description': 'The inner space of the bowel.', 'id': 'bowel_lumen'}}]
Sample Air node: [{'n': {'name': 'Air', 'description': 'A mixture of gases, primarily nitrogen and oxygen, used as a contrast agent in medical imaging to enhance visualization.', 'id': 'air'}}]
Sample DoubleContrastStudy node: [{'n': {'name': 'Double-contrast study', 'description': 'A medical imaging technique using both barium sulfate and air to enhance the visualization of the gastrointestinal tract.', 'id': 'double_contrast_study'}}]
Sample BariumEnema node: [{'n': {'name': 'Barium enema', 'description': 'A medical procedure in which barium sulfate suspension is introduced into the rectum and colon to enhance X-ray imaging of the lower gastrointestinal tract, often combined with air for a double-contrast study.', 'id': 'barium_enema'}}]
Sample BodyCavity node: [{'n': {'name': 'Body cavity', 'description': 'Any space or compartment in the body that contains and protects internal organs.', 'id': 'body_cavity'}}]
Sample MedicalProcedure node: [{'n': {'name': 'Injection', 'description': 'The act of forcing a fluid into a part, such as a blood vessel or body tissue. In this context, it refers to the administration of contrast agents into arteries or veins.', 'id': 'injection'}}]
Sample ChemicalSubstance node: [{'n': {'name': 'Contrast Agent', 'description': 'A substance used to enhance the visibility of internal structures in medical imaging. In this context, iodine-based molecules are used as contrast agents for visualizing arteries, veins, kidneys, ureter, and bladder.', 'id': 'contrast_agent'}}]
Sample PhysiologicalProcess node: [{'n': {'name': 'Excretion', 'description': 'The process of eliminating waste products from the body. Iodine is excreted via the urinary system.', 'id': 'excretion'}}]
Sample OrganSystem node: [{'n': {'name': 'Urinary System', 'description': 'The organ system responsible for producing, storing, and eliminating urine. Includes the kidneys, ureter, bladder, and urethra.', 'id': 'urinary_system'}}]
Sample Image node: [{'n': {'name': 'Precontrast Image', 'description': 'Images obtained before the injection of contrast media in subtraction angiography.', 'id': 'precontrast_image'}}]
Sample PhysicalProperty node: [{'n': {'name': 'Ultrasound', 'description': 'A very high frequency sound wave (not electromagnetic radiation) generated by piezoelectric materials.', 'id': 'ultrasound'}}]
Sample Computer node: [{'n': {'name': 'Computer', 'description': 'A device that can be instructed to carry out sequences of arithmetic or logical operations automatically.', 'id': 'computer'}}]
Sample MedicalDevice node: [{'n': {'name': 'CT Scanner', 'description': 'A device used in computed tomography (CT) to obtain a series of images of the body. It consists of an X-ray tube that passes around the body and detectors that measure the X-rays after they have passed through the body.', 'id': 'CT_scanner'}}]
Sample AnatomicalPlane node: [{'n': {'name': 'Axial Plane', 'description': 'A transverse plane that divides the body into superior and inferior parts. CT scanners obtain images in this plane.', 'id': 'axial_plane'}}]
Sample Radiation node: [{'n': {'name': 'X-ray', 'description': 'A form of electromagnetic radiation used in CT scans. It passes through the body and is detected to create images.', 'id': 'X-ray'}}]
Sample PhysicsConcept node: [{'n': {'name': 'Magnetic Field', 'description': 'A field produced by moving electric charges. In MRI, a strong magnetic field is used to align the protons in the body.', 'id': 'magnetic_field'}}]
Sample SubatomicParticle node: [{'n': {'name': 'Proton', 'description': 'A subatomic particle with a positive electric charge found in the nucleus of an atom. In MRI, the protons in hydrogen nuclei are used to generate signals.', 'id': 'proton'}}]
Sample ImagingParameter node: [{'n': {'name': 'Scan Weighting', 'description': 'The specific properties of an MRI scan determined by the pulse sequence, influencing the image contrast and tissue characteristics displayed.', 'id': 'scan_weighting'}}]
Sample ImagingType node: [{'n': {'name': 'T1-weighted Image', 'description': 'A type of MRI image where T1 properties are emphasized, resulting in dark fluid and bright fat. In the brain, cerebrospinal fluid (CSF) appears dark.', 'id': 't1_weighted_image'}}]
Sample Fluid node: [{'n': {'name': 'Intracellular Fluid', 'description': 'The fluid inside cells, comprising the cytoplasm.', 'id': 'intracellular_fluid'}}]
Sample Circulation node: [{'n': {'name': 'Peripheral Circulation', 'description': 'The circulation of blood in the blood vessels outside of the heart and lungs, supplying the limbs and other peripheral tissues.', 'id': 'peripheral_circulation'}}]
Sample Radionuclide node: [{'n': {'name': 'Technetium-99m', 'description': 'A commonly used radionuclide (radioisotope) in nuclear medicine with a half-life of approximately 6 hours, emitting a gamma ray at 140 keV. It is often combined with other molecules to form radiopharmaceuticals.', 'id': 'technetium_99m'}}]
Sample ChemicalCompound node: [{'n': {'name': 'Methylene diphosphonate', 'description': 'A chemical compound (MDP) that, when combined with technetium-99m, forms a radiopharmaceutical that specifically binds to bone, allowing assessment of the skeleton.', 'id': 'methylene_diphosphonate'}}]
Sample Radiopharmaceutical node: [{'n': {'name': 'Technetium-99m MDP', 'description': 'A radiopharmaceutical formed by combining technetium-99m with methylene diphosphonate (MDP). It is used for bone scans due to its specific binding to bone.', 'id': 'technetium_99m_mdp'}}]
Sample Absorption node: [{'n': {'name': 'Absorption', 'description': 'The process by which a substance is taken up into the body or a tissue.', 'id': 'absorption'}}]
Sample Distribution node: [{'n': {'name': 'Distribution', 'description': 'The process by which a substance is transported throughout the body.', 'id': 'distribution'}}]
Sample Metabolism node: [{'n': {'name': 'Metabolism', 'description': 'The set of chemical processes that occur within a living organism in order to maintain life.', 'id': 'metabolism'}}]
Sample Excretion node: [{'n': {'name': 'Excretion', 'description': 'The process of eliminating waste products from the body.', 'id': 'excretion'}}]
Sample GammaCamera node: [{'n': {'name': 'Gamma Camera', 'description': 'An imaging device used to detect gamma rays emitted by radiopharmaceuticals within the body, allowing for the creation of images showing the distribution of the radiopharmaceutical.', 'id': 'gamma_camera'}}]
Sample Imaging node: [{'n': {'name': 'Imaging', 'description': 'The process of creating visual representations of the interior of a body for clinical analysis and medical intervention.', 'id': 'imaging'}}]
Sample PositronEmissionTomography node: [{'n': {'name': 'Positron Emission Tomography', 'description': 'An imaging modality that detects positron-emitting radionuclides to visualize and measure metabolic processes in the body.', 'id': 'pet'}}]
Sample Positron node: [{'n': {'name': 'Positron', 'description': 'An antiparticle of the electron with a positive electric charge. Emitted from the decay of proton-rich radionuclides.', 'id': 'positron'}}]
Sample Cyclotron node: [{'n': {'name': 'Cyclotron', 'description': 'A type of particle accelerator used to produce radionuclides.', 'id': 'cyclotron'}}]
Sample Fluorodeoxyglucose node: [{'n': {'name': 'Fluorodeoxyglucose', 'description': 'A glucose analog labeled with fluorine-18, commonly used in PET imaging to assess glucose metabolism in tissues. It is a radiopharmaceutical.', 'id': 'fdg'}}]
Sample Fluorine18 node: [{'n': {'name': 'Fluorine-18', 'description': 'A positron-emitting isotope of fluorine used to label radiopharmaceuticals like FDG for PET imaging. It has a short half-life.', 'id': 'fluorine_18'}}]
Sample Glucose node: [{'n': {'name': 'Glucose', 'description': 'A simple sugar that is an important energy source in living organisms. FDG is an analog of glucose.', 'id': 'glucose'}}]
Sample HotSpot node: [{'n': {'name': 'Hot Spot', 'description': 'A localized area of high concentration of a radiopharmaceutical, indicating increased metabolic activity or uptake. Detected in PET imaging.', 'id': 'hot_spot'}}]
Sample Cancer node: [{'n': {'name': 'Cancer', 'description': 'A disease caused by uncontrolled division of abnormal cells in a part of the body.', 'id': 'cancer'}}]
Sample Recurrence node: [{'n': {'name': 'Recurrence', 'description': 'The return of a disease or condition after a period of remission.', 'id': 'recurrence'}}]
Sample SinglePhotonEmissionComputedTomography node: [{'n': {'name': 'Single Photon Emission Computed Tomography', 'description': 'An imaging modality that detects gamma rays emitted from injected radionuclides to create 3D images of the body.', 'id': 'spect'}}]
Sample GammaRay node: [{'n': {'name': 'Gamma Ray', 'description': 'A high-energy form of electromagnetic radiation emitted during radioactive decay.', 'id': 'gamma_ray'}}]
Sample Technetium99m node: [{'n': {'name': 'Technetium-99m', 'description': 'A gamma-emitting radionuclide commonly used in SPECT imaging.', 'id': 'technetium_99m'}}]
Sample Iodine123 node: [{'n': {'name': 'Iodine-123', 'description': 'A gamma-emitting radionuclide used in SPECT imaging.', 'id': 'iodine_123'}}]
Sample Iodine131 node: [{'n': {'name': 'Iodine-131', 'description': 'A gamma-emitting radionuclide used in SPECT imaging.', 'id': 'iodine_131'}}]
Sample CoronaryArteryDisease node: [{'n': {'name': 'Coronary Artery Disease', 'description': 'A condition in which the coronary arteries become narrowed or blocked, leading to reduced blood flow to the heart.', 'id': 'coronary_artery_disease'}}]
Sample BoneFracture node: [{'n': {'name': 'Bone Fracture', 'description': 'A break in the continuity of a bone.', 'id': 'bone_fracture'}}]
Sample RadiographyProcedure node: [{'n': {'name': 'Chest Radiograph', 'description': 'A common plain radiograph imaging technique used to visualize the chest, including the lungs, heart, and associated structures. It is typically performed posteroanteriorly (PA).', 'id': 'chest_radiograph'}}]
Sample QualityAssessment node: [{'n': {'name': 'Chest Radiograph Quality', 'description': 'The assessment of the quality of a chest radiograph based on visualization of anatomical structures and proper film markers.', 'id': 'chest_radiograph_quality'}}]
Sample MedicalSign node: [{'n': {'name': 'Dextrocardia', 'description': 'A congenital condition in which the heart is located on the right side of the chest instead of the left.', 'id': 'dextrocardia'}}]
Sample Indication node: [{'n': {'name': 'Small Bowel Obstruction', 'description': 'A blockage of the small intestine, preventing the passage of food and fluids. It is a clinical indication for an erect plain abdominal radiograph.', 'id': 'small_bowel_obstruction'}}]
Sample ContrastMedium node: [{'n': {'name': 'High-Density Contrast Medium', 'description': 'A contrast agent used in imaging to enhance the visualization of internal structures. In this case, it is ingested to opacify the esophagus, stomach, small bowel, and large bowel.', 'id': 'high_density_contrast_medium'}}]
Sample Gas node: [{'n': {'name': 'Air', 'description': 'A mixture of gases, primarily nitrogen and oxygen. Used to insufflate the bowel for double-contrast studies.', 'id': 'air'}}]
Sample Medication node: [{'n': {'name': 'Cathartics', 'description': 'Medications used to stimulate bowel movements and empty the bowel, often used in bowel preparation.', 'id': 'cathartics'}}]
Sample AnatomicalSystem node: [{'n': {'name': 'Urinary Tract', 'description': 'The system of organs involved in the production and excretion of urine, including the kidneys, ureters, bladder, and urethra.', 'id': 'urinary_tract'}}]
Sample Vessel node: [{'n': {'name': 'blood vessel', 'description': 'A blood vessel is a component of the cardiovascular system that transports blood throughout the body. Types include arteries, veins, and capillaries. The walls of blood vessels typically consist of three layers: tunica externa, tunica media, and tunica intima.', 'id': 'blood_vessel'}}]
Sample Fiber node: [{'n': {'name': 'elastic fiber', 'description': 'Elastic fibers are connective tissue fibers composed of elastin, providing elasticity and resilience to tissues. They are present in varying amounts within the tunica media of medium and large arteries, allowing these vessels to expand and recoil.', 'id': 'elastic_fiber'}}]
Sample VesselClass node: [{'n': {'name': 'artery', 'description': 'An artery is a blood vessel that carries blood away from the heart to other parts of the body. Arteries have thicker walls than veins, especially the tunica media, which contains smooth muscle and elastic fibers.', 'id': 'artery'}}]
Sample Physiology node: [{'n': {'name': 'cardiac cycle', 'description': 'The cardiac cycle is the sequence of events that occur during one complete heartbeat, including diastole (relaxation and filling) and systole (contraction and ejection).', 'id': 'cardiac_cycle'}}]
Sample Document node: [{'n': {'source': 'ADAM', 'document_id': 3184, 'url': 'https://www.nlm.nih.gov/medlineplus/ency/patientinstructions/000606.htm'}}]